NO ./textures/NO.xpm
SO ./textures/SO.xpm
WE ./textures/EA.xpm
EA ./textures/WE.xpm

C 255,100,100
F 2147483902,50,50

1111111111
1000N00001
1000000001
1000000001
1000000001
1000000001
1000000001
1000000001
1000000001
1111111111