NO textures/test/forbidden.xpm
SO textures/test/south.xpm
WE textures/test/west.xpm
EA textures/test/east.xpm

F 20,20,20
C 200,200,200


111111111
101000001
101000001
100001001
10000N001
100000001
111111111
