NO textures/test/forbidden.xpm
SO textures/test/south.xpm
WE textures/test/west.xpm
EA textures/test/east.xpm

F 20,20,20
C 200,200,200


111111111
100100001
100100001
100000001
100000001
100000001
100000001
100000111
10E000001
111111111
