NO textures/test/forbidden.xpm
SO textures/test/south.xpm
WE textures/test/west.xpm
EA textures/test/east.xpm

F 20,20,20
C 200,200,200


11111111
00111111
111N111
11111111
