NO textures/cover/astro.xpm
SO textures/cover/ye.xpm
WE textures/cover/heros.xpm
EA textures/cover/goodkidmadcity.xpm
F 169,169,169
C 49,140,231

1111111
1010001
100N011
1000001
1111111
