NO textures/ancientstone.xpm
SO textures/bluestone.xpm
WE textures/brick.xpm
EA textures/greystone.xpm

F 49,140,231
C 75,0,130


111111111
100100001
100100001
100000001
100000001
100000001
100000001
100000111
10E000001
111111111
